╔════════════╗╔════════════╗
║............║║............║
║.╔════════╗.║║.╔════════╗.║
║.║........║.║║.║........║.║
║.║.╔════╗.║.║║.║.╔════╗.║.║
║.║.║....║.║.║║.║.║....║.║.║
║.║.║.╔╗.║.║.║║.║.║.╔╗.║.║.║
║.║.║.║║.║.║.║║.║.║.║║.║.║.║
║.║.║.╚╣.║.║.║║.║.║.╠╝.║.║.║
║.║.║.1║.║.║.║║.║.║.║1.║.║.║
║.║.╚══╝.║.║.║║.║.║.╚══╝.║.║
║.║......║.║.║║.║.║......║.║
║.╚══════╝.║.║║.║.╚══════╝.║
║..........║E║║3║..........║
║ ╔════════╩═╝╚═╩════════╗ ║
║ ║                      ║ ║
║ ╚════════╦═╗╔═╦════════╝ ║
║..........║3║║!║          ║
║.╔══════╗.║.║║ ║ ╔══════╗ ║
║.║......║.║.║║ ║ ║      ║ ║
║.║.╔══╗.║.║.║║ ║ ║ ╔══╗ ║ ║
║.║.║.2║.║.║.║║ ║ ║ ║2 ║ ║ ║
║.║.║.╔╣.║.║.║║ ║ ║ ╠╗ ║ ║ ║
║.║.║.║║.║.║.║║ ║ ║ ║║ ║ ║ ║
║.║.║.╚╝.║.║.║║ ║ ║ ╚╝ ║ ║ ║
║.║.║....║.║.║║ ║ ║    ║ ║ ║
║.║.╚════╝.║.║║ ║ ╚════╝ ║ ║
║.║........║.║║ ║        ║ ║
║.╚════════╝.║║ ╚════════╝ ║
║............║║            ║
╚════════════╝╚════════════╝