/===============\
|o......|......o|
|./\./\.|./\./\.|
|.||.\/.|.\/.||.|
|.\/.........\/.|
|..../==.==\....|
\=.|.|.....|.|.=/
1..|.|.| |.|.|..1
/=.|...|!|...|.=\
|....|.\=/.|....|
|.=\.|..E..|./=.|
|..|.../=\...|..|
|=.|.|.\=/.|.|.=|
|....|..|..|....|
|.=====.|.=====.|
|o.............o|
\===============/