/======\2/======\
|4.............3|
|./\./\.|./\./\.|
|.||.\/.|.\/.||.|
|.\/.........\/.|
|o.../==.==\...o|
\=.|.|.....|.|.=/
1..|.|.| |.|.|..1
/=.|...|!|...|.=\
|....|.\=/.|....|
|.=\.|..E..|./=.|
|..|.../=\...|..|
|=.|.|.\=/.|.|.=|
|o...|..|..|...o|
|.=====.|.=====.|
|3.............4|
\======/2\======/